***********#*##***#*
*##*##**##*##*##*#*#
#***##*#*##****##*##
#**#*#*#*******#****
#**#******##*#***##*
##****#****#*****#**
####**#*###**#******
********##****##*###
**#***#**#******#*#*
###*#*###**##**#*##*
*#****##**#*#**###**
##**#*###*##*#**####
#*#*###*****#*****##
**#*##***###*###*###
###**#**##**##***#**
*##***###****#******
#***#**##*#*****#*#*
*##**#*#*#####*##**#
#*##*#####***#*#*#**
*#*#***#*#*###*##*#*
