**#*#***#####****##*
**#******#*#*###*###
#***##*#*#***#******
**#**##***##*###**##
####**#*********##*#
###*#*##****#*#**#**
######**#*#****##**#
*##*##*#**###******#
#*##***#**#*#***#*##
##**######**#*#**##*
***###**##****#*#*##
#*##*##*****#***#**#
#*#*#****##*####**#*
*###*####******#***#
*###**#***#*****###*
#****##*#####*##****
*##*##**********##*#
#****######****####*
##*#**####**##****#*
#***#*#*##****#*****
