*#*#*#*##*#*****##**
****#****#****#*#*##
**#**#*#**##**##*#**
*******#*****#####*#
*****#**#**#******#*
**###***#**#*******#
****#**###*###*##*#*
##*#******#*##****##
##*#*#*###**#**#**#*
***##*##*#*#*#*#***#
***#*****#**#****#**
***##**##*####*##**#
#*#*##*##**##******#
##****##*#*#*####***
**##***#***#######**
**#*###*#**#**##*#**
#***####*####*#*###*
##*###*#***##*#*#*#*
#*#*#***###*##******
#*#****#**##**####**
