10000000000000000000
11110011100000000000
00011010110000000000
00001110011110000000
00000000000011111100
00000000000000000100
00000000000000000100
00000000000000000100
00000000000000000100
00000000000000000110
00000000000000000010
00000000000000000010
00000000000000000010
00000000000000000011
00000000000000000001
00000000000000000001
00000000000000000001
00000000000000000001
00000000000000000001
00000000000000000001
